93,93,93,93,93,93,93,93,93,93,93,93,93,93,93,93,93,93,93,93,93,93,93,93,93,93,93,93,93,93,93,93,93,93,93,93,93,93,93,93,93,93,93,93,93,93,93,93,93,93,3,3,2,2,2,2,2,2,2,3,3,3,3,93,93,93,93,93,93,93,93,93,93,93,93,93,93,
93,93,93,93,93,93,93,93,93,93,93,93,93,93,93,93,93,93,93,93,93,93,93,93,93,93,93,93,93,93,93,93,93,93,93,93,93,93,93,93,93,93,93,93,93,93,93,93,93,3,3,2,2,2,2,2,2,2,2,2,2,2,3,3,93,93,93,93,93,93,93,93,93,93,93,93,93,
93,93,93,93,93,93,93,93,93,93,93,93,93,93,93,93,93,93,93,93,93,93,93,93,93,93,93,93,93,93,93,93,93,93,93,93,93,93,93,93,93,93,93,93,93,93,93,93,3,3,2,2,2,2,2,2,2,2,2,2,2,2,2,3,3,3,93,93,93,93,93,93,93,93,93,93,93,
93,93,93,93,93,93,93,93,93,93,93,93,93,93,93,3,3,3,3,3,3,3,3,3,3,93,93,93,93,93,93,93,93,93,93,93,93,93,93,93,93,93,93,93,93,93,93,3,3,2,2,2,2,2,2,2,2,2,2,2,2,2,2,2,3,3,3,93,93,93,93,93,93,93,93,93,93,
93,93,93,93,93,93,93,93,93,93,93,93,3,3,3,3,2,2,2,2,2,2,2,2,3,3,3,3,93,93,93,93,93,93,93,93,93,93,93,93,93,93,93,93,93,93,3,3,2,2,2,2,2,2,1,1,1,1,1,1,2,2,2,2,2,3,3,3,93,93,93,93,93,93,93,93,93,
93,93,93,93,93,93,93,93,93,93,93,3,3,2,2,2,2,2,2,2,2,2,2,2,2,2,3,3,3,3,93,93,93,93,93,93,93,93,93,93,93,93,93,3,3,3,3,3,2,2,2,2,1,1,1,1,1,1,1,1,1,1,2,2,2,3,3,3,3,3,3,93,93,93,93,93,93,
3,3,3,3,3,3,3,3,3,3,3,2,2,2,2,2,2,2,2,1,1,1,1,2,2,2,2,2,3,3,3,3,3,3,3,3,3,3,3,3,3,3,3,3,2,2,2,2,2,2,1,1,1,1,1,1,1,1,1,1,1,1,1,1,2,2,2,2,2,2,2,3,3,3,3,3,3,
2,2,2,2,2,2,2,2,2,2,2,2,2,2,2,1,1,1,1,1,1,1,1,1,2,2,2,2,2,2,2,2,2,2,2,2,2,2,2,2,2,2,2,2,2,2,2,2,1,1,1,1,1,1,1,1,1,1,18,18,18,1,1,1,2,2,2,2,2,2,2,2,2,2,2,2,2,
2,2,2,2,2,2,2,2,2,2,2,2,2,2,2,1,1,1,1,1,1,1,1,1,18,18,2,2,2,2,2,2,2,2,2,2,2,2,2,2,2,2,2,2,2,2,2,1,1,1,1,1,1,1,1,1,1,1,1,18,18,18,18,18,1,1,1,2,2,2,2,2,2,2,2,2,2,
2,2,2,2,2,2,2,2,2,2,2,1,1,1,1,1,1,1,31,31,31,1,1,1,1,18,18,18,18,2,2,2,2,2,2,2,2,2,2,2,2,2,2,2,1,1,1,1,1,1,1,1,1,1,1,1,1,1,1,1,1,1,1,1,1,1,1,1,1,2,2,2,2,2,2,2,2,
2,2,2,2,2,2,2,1,1,1,1,1,1,1,1,1,1,1,1,1,1,1,1,1,1,1,1,1,18,18,1,1,1,1,1,2,2,2,2,2,2,2,1,1,1,1,1,1,1,1,1,43,43,1,1,1,1,1,1,1,1,1,30,1,1,1,1,1,1,1,2,2,2,2,2,2,2,
1,1,1,1,1,1,1,1,1,1,1,32,32,32,32,1,1,1,1,1,1,1,1,44,44,44,44,1,1,1,1,1,1,1,1,1,1,1,1,1,1,1,1,1,1,1,1,1,1,1,43,43,1,1,1,1,1,1,1,1,1,1,30,30,30,1,1,1,1,1,1,1,1,1,1,1,1,
1,1,1,1,1,1,1,1,1,1,32,32,1,1,1,1,1,1,1,1,1,1,1,1,1,44,44,44,44,44,1,1,1,1,1,18,18,18,18,18,18,18,18,1,1,1,1,1,1,1,1,1,1,1,1,1,1,1,1,1,1,1,1,1,30,1,1,1,1,1,1,1,1,1,1,1,1,

