3,3,3,3,3,3,3,3,3,3,3,3,3,3,3,3,
93,93,93,93,93,93,93,93,93,93,93,93,93,93,93,93,
93,93,93,93,93,93,93,93,93,93,93,93,93,93,93,93,
93,93,93,93,93,93,93,93,93,93,93,93,93,93,93,93,
93,93,93,93,93,93,93,93,93,93,93,93,93,93,93,93,
93,93,93,93,93,93,93,93,93,93,93,93,93,93,93,93,
93,93,93,93,93,93,93,93,93,93,93,93,93,93,93,93,
93,93,93,93,93,93,93,93,93,93,93,93,93,93,93,93,
93,67,67,93,93,65,93,93,93,69,93,93,93,66,93,93,
03,03,03,03,03,03,03,03,03,03,03,03,03,03,03,03,
02,02,02,02,02,02,02,02,02,02,02,02,02,02,02,02,
02,02,02,02,02,02,02,02,02,02,02,02,02,02,02,02,
02,02,02,02,02,02,02,02,02,02,02,02,02,02,02,02,
02,02,02,02,02,02,02,01,01,01,01,01,01,02,02,02,
02,02,02,01,01,01,01,01,01,01,01,01,01,01,02,02,
02,01,01,01,01,01,01,01,01,01,01,01,01,01,01,01,

